N,N,N,N,N,W,N,N,N
N,N,N,W,N,W,N,N,T
T,N,W,N,N,N,N,T,N
N,N,N,N,N,N,N,N,N
N,N,N,T,N,N,T,N,N
N,N,N,N,T,N,N,W,N
W,N,N,N,W,N,N,N,N
N,N,T,N,W,N,N,N,N
N,N,N,N,T,N,N,N,N
