N,N,W,W,N,N,T,W,N,N
N,N,N,N,N,W,W,N,N,T
W,N,T,N,N,N,N,N,N,W
T,N,W,W,N,N,T,T,W,N
N,W,N,W,N,N,N,N,N,N
N,W,N,N,N,W,N,W,N,N
W,N,T,T,N,N,N,W,N,T
N,W,N,N,N,N,N,T,N,W
T,N,N,N,W,N,N,N,N,N
N,N,N,T,N,N,N,W,W,N
