N,N,W,N,N,N,T,N,N,W,N,N
N,N,N,W,N,N,N,N,N,N,N,N
N,N,N,N,T,N,N,N,N,W,W,N
W,N,N,W,N,W,N,N,N,N,W,N
N,N,N,N,N,N,N,N,N,N,T,N
N,N,N,N,W,N,N,N,N,N,W,N
W,N,N,N,T,N,N,N,N,N,N,N
N,N,T,N,N,N,W,W,N,T,W,W
W,N,N,N,N,T,N,W,N,N,N,N
W,W,N,N,N,N,N,N,W,N,N,N
N,W,N,T,W,W,N,N,N,N,W,N
T,N,N,N,N,W,W,N,N,N,N,T
