N,,,,W,,,W,,,,,,,N
,,,,,,,W,,,,T,,,
,,,,,,,W,W,,,,,,
,T,,H,,T,,W,,,,H,,,
,,,,,,,W,,,,,,,W
,,,,,,,W,,,,T,,,
,,W,,,,,W,,,,,,,
