,,,,,W,,,,,,
,W,,,,,,,,,,
,,,,,,W,,,,,
,,,,,,,,W,,,
,,,,W,,,,,,,
W,,,,,,,,,,,
,,W,,,,,,,,,W
,,,,,,,W,,,,
,,,W,,,,,,,,
,,,,,,,,,,T,
,,,,,,,,,T,W,
,,,,,,W,,,,,W
