N,N,W,N,,N,T,N,N
N,N,N,N,,W,N,N,N
N,N,N,W,,N,N,N,RR
N,N,N,N,,N,N,N,N
N,N,N,H,W,H,N,RL,W
N,W,N,N,,W,W,N,T
T,N,N,T,,W,N,N,N
N,W,N,N,,N,N,T,N
N,W,N,T,,N,N,W,W
